1111111111111111
100000001C00C0C1
1001110P10000011
100C110C00000EC1
1111111111111111