1111111111111
1C010000000C1
10C0010111001
100P11E000001
1111111111111
